一 ichi|itsu|hito|hitotsu One
二 ni|ji|futa|futatsu Two
三 san|mit|mittsu Three
四 shi|yot|yottsu|yon Four
五 go|itsu|itsutsu Five
六 roku|mut|muttsu Six
七 shichi|nana|nanatsu Seven
八 hachi|yat|yattsu Eight
九 ku|kyuu|kokono|kokonotsu Nine
十 juu|tou Ten
百 hyaku|momo Hundred
千 sen|chi Thousand
上 jou|ue Top, above
下 ka|ge|shita|shimo|moto Bottom, below
左 sa|hidari Left
右 u|yuu|migi Right
中 chuu|juu|naka Inside, middle
大 dai|tai|ou|oukii Large
小 shou|chii|chiisai|ko|o Small
月 gatsu|getsu|tsuki Month, moon
日 nichi|jitsu|hi|ka Day, sun
年 nen|toshi Year
早 sou|sa|haya|hayai Early
木 moku|boku|ki Tree
林 rin|hayashi Woods
山 san|zan|yama Mountain
川 sen|kawa River
土 do|to|tsuchi Soil
空 kuu|sora|a|aku|kara Sky
田 den|da|ta Rice paddy
天 ten|ame|ama Heaven
生 sei|shou|i|ikiru|u|umu|nama Life, bear, raw
花 ka|hana Flower
草 sou|kusa Grass
虫 chuu|mushi Insect
犬 ken|inu Dog
人 jin|nin|hito Person
名 mei|myou|na Name
女 jo|nyo|onna Female
男 dan|nan|otoko Male
子 shi|su|ko Child
目 moku|me Eye
耳 ji|ni|mimi Ear
口 kou|kuchi Mouth
手 shu|te Hand
足 soku|ashi Foot
見 ken|gen|mi|miru See
音 on|ne|oto Sound
力 riki|ryoku|chikara Power
気 ki|ke|iki Spirit, air
円 en|maru Yen, circle
入 nyuu|hai|hairu|i|iru Enter
出 shutsu|de Exit
立 ritsu|ta|tatsu Stand up
休 kyuu|yasu|yasumu Rest
先 sen|saki Previous
夕 seki|yuu Evening
本 hon|moto Book
文 bun|mon|fumi Text
字 ji|aza Character
学 gaku|mana|manabu Study
校 kou|kase School
村 son|mura Village
町 chou|machi Town
森 shin|mori Forest
正 sei|shou|tada|tadashii|masa Correct
水 sui|mizu Water
火 ka|hi Fire
玉 gyoku|tama Gem
王 ou|kimi King
石 seki|koku|ishi Stone
竹 chiku|take Bamboo
糸 shi|ito Thread
貝 bai|kai Shellfish
車 sha|kuruma Vehicle
金 kin|kane|kana Gold, money
雨 u|ame|ama Rain
赤 seki|aka Red
青 sei|shou|ao Blue
白 haku|shiro|shira White