人 hito|jin|nin Personne, être humain
犬 inu|ken Chien
男 otoko|o|kun|nan Homme, de sexe masculin
女 onna|me|jo|nyo|nyou Femme, de sexe féminin
私 watashi|watakushi|shi Je, Moi
本 hon|moto Livre, origine
日 hi|bi|ka|nichi|jistu Jour, soleil
猫 neko Chat
学 mana|gak|gaku Etudier, apprendre
生 i|u|sei|jou|shou|nama Naître, vivre
趣 omomuki|shu Sens, ton, goût, influence
味 aji|mi Goût, saveur, goûter
音 oto|ne|on|in Bruit, son
楽 tano|gaku|raku Amusant, plaisant, agréable
映 utsu|ei Refléter, projeter
画 kaku|ga Trait, tracé, image, dessin, peinture
名 na|mei|myou Nom
前 mae|zen Devant, avant, antérieur
国 kuni|koku|goku Pays
読 yo|doko|toku|too Lire
聞 ki|bun|mon Entendre, écouter
見 mi|ken Regarder, voir, montrer
語 kata|go Raconter, mot, langue, langage
魚 sakana|uo|gyo Poisson
卵 tamago|ran Oeuf, embryon
話 hana|hanashi|wa Parler, raconter, histoire, récit, propos
食 ta|shoku Manger
飲 no|in Boire
今 ima|kon|kin Maintenant, présent, actuel
朝 asa|chou Matin, dynastie
時 toki|ji Moment, temps, heure
行 i|okona|gyou|kou Aller, faire, agir
来 ku|kita|rai Venir, avenir
帰 kae|ki Retourner
明 aka|mei|myou Clair, éclairé, lumineux
館 kan Grand bâtiment, bâtiment public
家 uchi|ie|ya|ka|ke Maison, foyer, famille
昨 saku Passé
友 tomo|yuu Ami, amitié
達 dachi|tachi|tatsu Suffixe qui marque le pluriel, atteindre
何 nan|nani|ka Quoi, quel, comment
晩 ban Soir
緒 o|sho|cho Début, commencement, cordon, ficelle
買 ka|bai Acheter
大 oo|dai|tai Grand, gros, important
小 chii|go|o Petit
先 saki|ma|sen Devant, avant, d'abord
車 kuruma|sha Voiture, véhicule
円 en Yen, circulaire
高 taka|kou Haut, élever, cher
安 yasu|an Bon marché, calme, tranquille, rassuré
新 atara|shin Sens, ton, goût, influence
同 ona|dou Identique
速 haya|soku Rapide, tôt
好 su|kono|kou Aimé, apprécié
古 furu|ko Vieux, ancien
遅 o|oku|chi Lent, tard, en retard
嫌 kira|iya|ken|gen Détester, dégoutant, désagréable
子 ko|shi|su Enfant, graine, jeune pousse
有 a|yuu Avoir, posséder, exister
歌 uta|ka Chant, chanter, poème
手 te|ta|shu|zu Main
優 yasa|sugu|yuu Gentil, aimable, exceller, acteur
分 wa|bun|fun|pun|bu Minute, partie, diviser
秒 byou Seconde (temps)
半 naka|han Demi, moitié
午 go Midi
後 ato|ushi|nochi|go|koo Après, derrière
郵 yuu Poste, collecte et distribution
便 bin|ben Commodité, lettre, courrier
局 kyoku Bureau, département
銀 gin Argent (metal)
駅 eki Gare, station
喫 kitsu Avaler, absorber
茶 cha|sa Thé
店 mise|ten Magasin, commerce
冷 tsume|hi|sa|rei Frois, glacé, réfrigérer, se refroidir
蔵 kura|zou Entrepôt, magasin
庫 ko Dépôt, réserve
肉 niku Viande, chair
牛 ushi|gyuu Vache, bovin
芋 imo patate|tubercule
勉 ben Travail, effort
強 tsuro|kyou Fort, puissant
僕 boku Je, moi, tu, toi (pour un garçon ou homme)
東 higashi|tou L'est (direction)
京 miyako|kei|kyou Capitale
英 ei Grande-Bretagne, brillant, talentueux
荷 ni|ka Charge, fardeau
物 mono|butsu|motsu Chose, objet
準 jun demi-, quasi, préparatifs
備 sona|bi Equipé, fourni
週 shuu Semaine
月 tsuki|getsu|gatsu Lune, mois
曜 you Jour de la semaine
旅 tabi|ryo Voyage
面 otome|men Face, surface
白 shiro|byaku|haku Blanc, pureté
辺 ata|hen|pen Environs, voisinage
息 iki|soku Respiration, souffle
娘 musume Fille (ma)
遊 aso|yuu Jouer, s'amuser, se divertir
脱 nu|datsu Ôter, enlever un (vêtement), omettre
待 ma|tai Attendre
死 shi Mort, mourir
元 moto|gen Base, origine, cause
気 ki|ke Esprit, énergie, sentiment
天 ten Ciel, céleste
族 zoku Famille, clan
海 umi|kai Mer
悪 waru|aku Mal, vice, méchant
泳 oyo|ei Nager
思 omo|shi Penser, croire
土 tsuchi|do|to Sol, terre
仕 tsuka|shi Servir, être au service de
事 koto|goto|ji|zu Chose, affaire
忙 isoga|bou Être occupé
皆 mina|minna|kai Tout le monde, tous
出 de|da|sui|shutsu Sortir, faire sortir
公 kou|ku Public, officiel
園 sono|en Jarden
辞 ya|ji Renoncer, cesser, expression
変 ka|hen Changer, étrange
他 hoka|ta Autre
火 hi|ka Feu, flamme
水 mizu|sui Eau
木 ki|moku|boku Arbre, bois
金 kane|kin|kon Métal, or, argent (monnaie)
星 hoshi|boshi|sei Étoile, planète
当 a|tou Viser, toucher, destiner
活 katsu Vie, activité
慣 na|kan S'habituer
教 oshi|kyou Enseigner
校 kou Bâtiment d'école
会 a|e|kai Rencontrer
社 yashiro|sha Compagnie, association, sanctuaire shinto
下 shita Dessous, en dessous
横 yoko À côté de
中 naka Dedans, à l'intérieur
探 saga|tan Chercher, sonder, espionner
場 ba|jou|chou Lieu, endroit
所 tokoro|dokoro|jo|sho Endroit, lieu
通 doo|too|tsuu Rue, voie, pénétrer, fréquenter
知 shi|chi|ji Savoir, connaître
右 migi|u Droite
左 hidari|sa Gauche
曲 ma|kyoku Tourner, courber, mélodie
側 gawa|kawa|soku Côté, flanc
使 tsuka|shi Utiliser
誘 saso|yuu Inviter, inciter
秘 hi Secret
密 mitsu Dense, compact, secret
集 atsu|shuu Chaud (temps)
部 he|bu Partie, section
全 matta|sube|zen Complètement, tout
誕 tan Nativité, être né
道 michi|dou|tou Chemin, rue, route, voie
真 ma|shin Vérité, exactitude
直 nao|choku|jiki Réparer, corriger, franc, honnête
信 shin Confiance, croyance
号 gou Numéro
角 kado|tsuno|kaku Coin, angle, corne
目 me|moku Oeil, -ième
警 kei Avertir
官 kan Service gouvernementale, bureaucracie
回 kai Fois
言 gen|gon|iu|koto Mot, remarque (Verbe dire)
昔 mukashi|seki Autrefois, jadis
歳 sai Ans (pour l'âge)
山 yama|san|zan Montagne
住 su|juu Habiter, résider
父 chichi|fu Papa, père
嬉 ure Heureux, content
顔 kao Visage, face
馬 uma|ma|ba Cheval
自 mizuka|ji|shi Soi-même
乗 noru|nori|jou|shou Monter (véhicule), pouvoir, multiplication
世 yo|se|sei Monde, époque, génération
界 kai Limite, frontière, monde
発 hatsu|hotsu|patsu Départ, donner naissance
早 haya|sou Courir, tôt
遠 too|en Éloigné, distant
町 machi|chou Ville, agglomération, quartier
春 haru|shun Printemps
波 nami|ha Vague
最 motto|sai Le plus
始 haji|shi Commencer
母 haha|bo Maman, mère
選 era|sen Choisir
走 hashi|sou Courir
川 kawa|gawa|sen Rivière, cour d'eau
森 mori|shin Forêt
夢 yume|mu Rêve illusion
叶 kana Exaucer (un voeu, une prière)
無 na|bu|mu Rien, négation, ne pas être, perdre
理 ri Raison, principe, logique
心 kokoro|shin Coeur, sentiment, âme
配 hai|pai Livrer, distribuer
運 hako|un Transporter, destin, chance
命 inochi|mei Vie, destin, ordre (donner un)
必 kanara|hitsu Inévitable, certain
予 arakahi|yo A l'avance, au préalable
報 muku|hou|pou Informations, nouvelles, récompenser
低 hiku|tei Bas, abaisser
温 atata|on Chaleur, douceur, agréable
度 tabi|do|taku Degré, fois, compenser
晴 ha|sei Beau temps, s'éclaircir
想 sou Idéal
雨 ame Pluie
降 fu|o|kou Descendre, tomber
暑 atsu|sho Chaud (temps)
外 soto|hoka|gai|ge Extérieur, autre
動 ugo|dou Bouger, se déplacer
取 to|shu Prendre, saisir
干 ho|hi|kan Aérer, sécher
診 mi|shin Examiner, diagnostiquer
察 satsu Supposer, deviner, juger
終 o|shuu Finir, se terminer
普 fu Généralement
風 kaze|fu|fuu Vent, style, apparence
邪 ja Mal, injustice
違 chiga|i Être différent
移 utsu|i Se déplacer, se transporter
入 hai|i|nyuu Entrer, faire entrer, mettre
良 i|yo|ryou Bon, bien, satisfaisant
寝 ne|shin Dormir
酒 sake|shu Alcool, saké, alcool de riz